0 0 0 255
50 700
5
0 0 1000 50 0 255 0 255 0
100 300 50 50 255 0 0 255 1
300 20 50 50 255 0 0 255 1
400 20 50 50 255 0 0 255 1
800 500 500 50 0 255 0 255 0