0 0 0 255
10 10
6
393 230 100 100 255 0 0 255 1
175 362 100 100 0 255 0 255 0
245 171 100 100 255 0 0 255 1
391 432 100 100 0 255 0 255 0
555 316 100 100 0 255 0 255 0
521 139 100 100 0 255 0 255 0
